################################################################
#         #                                                    #
# S       #                                                    #
#         #                                                    #
#######   #                                                    #
#     #   ######################################################
#     #                    #           #                       #
#     #                    #           #                       #
#     #      ######        #                         #   #     #
#     #      #             #                         #   #     #
#     #      #                         ###############   #######
#     #      #                         #                       #
#     #                                #  E                    #
#     #                                #                       #
################################################################